10
10
(2,0)
(8,9)
## #######
#        #
##       #
### #### #
##  #    #
#  #### ##
## ##    #
##  ###  #
### #    #
######## #
