10
10
(2,0)
(3,9)
## #######
#   ##   #
#      # #
### #### #
##  #    #
#  #### ##
#  ##    #
##  ###  #
### #    #
### ######
