61
101
######################################################### ###
#                             #                         #   #
# ##################### ### # # # ####### ################# #
# #     #             #   # # # # #     # #                 #
# # # # # ########### ##### # ### # ### # # #################
# # # # # #               # #     #   #   # #     #         #
# # # # # ############### # ############### ##### # ####### #
# # # # #               # #               # #     # #     # #
# # # # ############### # ########### ### # # ### # ##### # #
# # # #               # #           # # # # # #   # #     # #
# ### ################# ########### # # # # # ##### # ### # #
#     #                 #         # #   # # #     # # #   # #
##### # ################# ### ### # ##### # # ### # # # ### #
#   # # #               # # # # # #     # # # # # # # # # # #
# # # # # ############### # # # # ##### # # # # # # # # # # #
# # # # #               #   # #       #   # # # # # # #   # #
# ### # # ############# ### # ########### # # # # # # ##### #
#     # # #           #   # #             # # # # # #     # #
####### # ########### # # # ############### # # # # ##### # #
#       #             # # #       #       # #   # #       # #
# ################### # ######### # ##### # ##### ####### # #
# #       #         # #         # # #   # # #   # #       # #
# # ##### # ##### # # ######### # # # # # # # # # # ####### #
# # #   # # #   # # # #       # # # # # # # # # # # #     # #
# # # # # # # # # # # # ##### # # # # # # # # # # # # ### # #
# # # # # # # # # # #   #   # # # # # #   # # #   # # #   # #
# # # # # # # # # # ##### # # # # # ####### # ##### # ##### #
# # # # #   # # # # #     # # #   #       # #       #     # #
# # # ####### # # # ####### # ########### # # ########### # #
# # #         # # #         # #           # # #           # #
# # ######### # # ########### # ### ####### # ### ####### # #
# # #       # # #           # #   # #       #     #       # #
# # # ##### # # ########### # ##### # ##################### #
# # # #   # # # #         #         # #                     #
# # # # ### # # # ####### ########### # ################### #
# # # #     # # # #     #             # #                 # #
# # # # ##### # # # # ################# # ######### ##### # #
# #   #       # # # # #           #     # #       # #   # # #
# ############### # ### ######### # ### # # ##### # # ### # #
#               # #             # # # # # # # #   # #     # #
# ########### # # ############# # # # # # # # # # # # ##### #
# #   #     # # #       #     # # # # # # # # # # # # #   # #
# ### # ### ### ####### # ##### # # # # # # # # # # # ### # #
# #   # #             # #       # #   # # #   # # # #     # #
# # # # # ############# # ####### # ### # ### # # # ####### #
# # # # # # #           # #     #   #   # # # # # #         #
# # # # # # # ########### # ### ##### ### # # # # ###########
# # # # # # # #   #   # # # # #     # # # # # # # #         #
# # # # # # # # # # # # # # # # ##### # # # # # # # ####### #
# # # # # # # # # # # # # # # # #     # # # # # # # #     # #
# # # # # # # # # # # # # # # # # ##### # # # # # # ##### # #
# # # # # # # # #   #   # # #   # #     # #   # # #       # #
# # # # # # # # ######### # ##### # ### # # ### # ######### #
# # # # # # # #           # #     #   # # #   # #           #
# # # # # # # # ########### # ######### # ##### # ######### #
# # # # #   # # #           # #         # #     # #     #   #
# # # # ### # # # ######### # # ### ### # # ####### ### # ###
# # # # # # # # #         # # # # # # # # #           # # # #
# # # # # # # # ########### # # # # # # # ########### # # # #
# # # # # # # #             # #   # #   #           # # # # #
# # # # # # # ############### ### # ############### ### # # #
# # # # #   #               # #   #               #     #   #
# # # # ################### # ########### ####### ######### #
# # # #                   # #           # #     # #   #     #
# # ############### ##### # ##### ##### # # ### # # # # #####
# #               # #     #     # #   # # # # # # # # # #   #
# # ############# # # ######### # # # # # # # # # # ### # # #
# #       #     # # # # #     # # # # # # # # # # #   # # # #
# ####### # ### # # # # # ### # # # # # # # # # # # # # # # #
# #   # # #   # # # # # # # # # # # # # # # #   # # # # # # #
# # # # # ##### # # # # # # # # # # # # # # ##### ### # ### #
# # # #         # # # # # # # # #   # # # #           #     #
# # # ######### # # # # # # # # ####### # ################# #
# # #       #   # # # # # # # #       # #                   #
# # ####### ##### # # # # # # ####### # ############### #####
# #     #         # #   #   #       # #               # #   #
# ##### # ####### # ### ### ####### # # ############# # # ###
# #     # #   #   # # # # # #     # # # #           # # #   #
# # ##### # # # ### # # # # # ### # # # ########### # # # # #
# # #     # # # # # # # # # # # # # # #             # # # # #
# # ####### # # # # # # # # # # # # # ############### # # # #
# #         # #   # #     # # # # # #                 # # # #
# ########### ### # ####### # # # # ################### # # #
#           # #   #         # # # #       #           # # # #
########### # ############### # # # ##### # ##### ### # # # #
#       # # #                 # # # #     #     # #   # # # #
# ### # # # ############# ### # # # ##### ####### ##### # # #
# # # #   #             # # # # # #     #         #     # # #
# # # ################# # # # # # ##### ######### # ####### #
#   #                   #   # # # #   # #       # # #     # #
### ######################### # # # # # # ####### # ### # # #
# #         #               # # # # # # #         #     #   #
# ######### # # ########### # # # # # # # ################# #
#         # # # #         # # # # # # # #                 # #
# ####### # # # # ####### # # # # ### # ################### #
# #     # # # # # #       # # #       #                     #
# # # ### # # # # # ####### # ###############################
# # #     # # # # #       # #                               #
# ######### ### # ######### ########### ################### #
#               #                       #                   #
######################################### ###################
